WWWWWWWWWWWWWWWWWWWWWWWWWWWWWWWWWWWWWWWWWWWWWWWWWWWWWWWWWWWWWWWWWWWWWWWWWWWWWWWWWWWWWWWWWWWWWWWWWWWWW
W........WW.........................................................................................W
W........W..........................................................................................W
W........WWW........................................................................................W
W........W..........................................................................................W
W........W..........................................................................................W
W........W..........................................................................................W
W........W..........................................................................................W
W........W..........................................................................................W
WWWWWWWWWW..........................................................................................W
....................................................................................................W
W...................................................................................................W
W...................................................................................................W
W...................................................................................................W
W...................................................................................................W
W...................................................................................................W
W...................................................................................................W
W...................................................................................................W
W...................................................................................................W
W...................................................................................................W
W...................................................................................................W
W...................................................................................................W
W...................................................................................................W
W...................................................................................................W
W...................................................................................................W
W...................................................................................................W
WWWWWWWWWWWWWWWWWWWWWWWWWWWWWWWWWWWWWWWWWWWWWWWWWWWWWWWWWWWWWWWWWWWWWWWWWWWWWWWWWWWWWWWWWWWWWWWWWWWWW
